#############
#.p.#.......#
##.##.#######
#...#.......#
#..########.#
#.........#.#
#.#####.#m#.#
#.......#...#
#############