#########
#0##.#..#
#.##.#..#
#....##.#
#....####
#......m#
#########
