#####
#.p.#
##.##
#...#
#..##
#..m#
#####