#########
#.p.....#
#.#...#.#
#.#...#.#
#.#####.#
#......m#
#########