#############
#.p.........#
##.########.#
#...#.......#
#..########.#
#.....m...#.#
#.#####.#.#.#
#.......#...#
#############