#######################
#....................p#
#.....................#
#.....................#
#.....................#
#.....................#
#.....................#
#.....................#
#.....................#
#.....................#
#.....................#
#.....................#
#.....................#
#.....................#
#c....................#
#######################