#############################################
#######......################################
#####...####...####.#########################
###...########..##...########################
###.###########.......#####...###############
###.############.................############
###.###########...................###########
###.############....................#########
###p############....................#########
#################....................########
##################....................#######
##################....................#######
#################......................######
#################......................######
#################......................######
#################......................######
#################......................######
#################......................######
#################.....................#######
##################....................#######
##################....................#######
###################..................########
####################................#########
#####################..............##########
######################............###########
########################...c....#############
#############################################
#############################################
