########################
#..p#############...####
#...#########.......####
#...#########.###...####
##.##########.##########
##.....................#
#########.############.#
###...###.############.#
###...###.#####...####.#
###...###.........####.#
####.####.#####...####.#
####.####.############.#
####......############.#
######.#########c..##..#
####....########......##
####....########...#####
########################