###########
#0...#.#..#
#.#...##..#
#.#.......#
###.......#
##.#...#.m#
###########
