#######
#0.#.##
#.....#
#.....#
##...##
#....m#
#######
