#######
#0#..##
#.....#
#.....#
#.....#
#....m#
#######
