###########
#0#.....#.#
#...#...#.#
#..###..###
##........#
##.#...##m#
###########
