#########
#0.####.#
#.......#
#.......#
###.#.###
##.#...m#
#########
