############
#p.........#
#####.####.#
#m....#....#
#.....#....#
#..........#
############