#########
#m#.c.#m#
#0.cmc.1#
#m#.c.#m#
#########