#########
#p.c....#
#.#c#c#.#
#...c...#
#.#cmc#.#
#...c...#
#.#c#c#.#
#....c.p#
#########