#########
#p.c...m#
#.#c#c#.#
#...cmc.#
#.#cmc#.#
#.cmc...#
#.#c#c#.#
#m...c.p#
#########