#####
#.p.#
#...#
#...#
#...#
#.m.#
#####