#########
#0..#.#.#
#......##
#.#.....#
#...#..##
##..#..m#
#########
