###########
#0...#..#.#
#.#.#..##.#
#...#.#.###
###...##..#
#.......#.#
##...#..#.#
#......#.##
#.####.####
##.#.....m#
###########
