###########
#0.#..#..##
#...#.#...#
#.#.......#
#.....##..#
##.#...#.m#
###########
