###########
#0.#..#...#
#.....#.###
##.#......#
#..##.#####
#.........#
##......#.#
##..#..##m#
###########
