###########
#0..#..#..#
#...##....#
##........#
#......##.#
#.#..#..#.#
#..#.####.#
#.#.##.#.m#
###########
