###########
#0...#..###
#........##
#....#....#
#..##.#..##
#.#.####.m#
###########
