#########
#0...#.##
##.#....#
#.#.....#
#.#....##
#...##.##
##.....##
#..#..#.#
####...##
#.##...m#
#########
